..O.......O.......O..
.O..^^^^^..O.WWW.O...
O....^^^....W.W.W...O
.....^.^.....W.W.....
..O...^...O...W...O..
......^..............
..OOO.^.OOO.WWW.OOO..
......^..............
..O...^...O...W...O..
.....^.^.....W.W.....
O....^^^....W.W.W...O
.O..^^^^^..O.WWW.O...
..O.......O.......O..
