...........
..O.O.O....
...........
.O..^..O...
...........
...W.W.W...
...........
.O..^..O...
...........
..O.O.O....
...........
